30 60
20 50

XXXXXXXXXXXXXXXXXXXXXXXXXXXXXXXXXXXXXXXXXXXXXXXXXXXXXXXXXXXX
X                                                          X
X                       X                                  X
X                       X                                  X
X                       X                                  X
X                       X                                  X
X                       X                                  X
X     XXXXXXXXXX                                           X
X                                                          X
X                                                          X
X                                        XXX               X
X                                          X               X
X                                          X               X
X                                          X               X
X                                                          X
X                                                          X
X                                                          X
X                                                          X
X                                                          X
X                                                          X
X                                                          X
X                                                          X
X       XXXXXXXXXXXX                                       X
X                  X                                       X
X                  X                                       X
X               X   X                                      X
X               X   X                                      X
X               X   X                                      X
X                                                          X
XXXXXXXXXXXXXXXXXXXXXXXXXXXXXXXXXXXXXXXXXXXXXXXXXXXXXXXXXXXX